110111111111111111
10000000000C0C0001
1000000000000000C1
1P0000E00000000001
111111111111111111